{
  "type": "alpha",
  "data":{
    "tileMap":[
      [7,7,7,7,7,7,7,7,7,7,7,7,7,7,7,7,7,7,7,7,7,7,7,7,7,7,7,7,7,7],
      [7,7,7,7,7,7,7,7,7,7,7,7,7,7,7,7,7,7,7,7,7,7,7,7,7,7,7,7,7,7],
      [7,7,7,7,7,7,7,7,7,7,7,7,7,7,7,7,7,7,7,7,7,7,7,7,7,7,7,7,7,7],
      [7,7,7,7,7,7,7,7,7,7,7,7,7,7,7,7,7,7,7,7,7,7,7,7,7,7,7,7,7,7],
      [7,7,7,7,7,7,7,7,7,7,7,7,7,7,7,7,7,7,7,7,7,7,7,7,7,7,7,7,7,7],
      [7,7,7,7,7,7,7,7,7,7,7,7,7,7,7,7,7,7,7,7,7,7,7,7,7,7,7,7,7,7],
      [7,7,7,7,7,7,7,7,7,7,7,7,7,7,7,7,7,7,7,7,7,7,7,7,7,7,7,7,7,7],
      [7,7,7,7,7,7,7,7,7,7,7,7,7,7,7,7,7,7,7,7,7,7,7,7,7,7,7,7,7,7],
      [7,7,7,7,7,7,7,7,7,7,7,7,7,7,7,7,7,7,7,7,7,2,2,2,2,7,7,7,7,7],
      [7,7,7,7,7,7,7,7,7,7,7,7,7,7,7,7,7,7,7,7,7,4,4,4,4,7,7,7,7,7],
      [7,7,7,7,7,7,7,7,7,7,7,7,7,7,7,7,7,7,7,7,7,4,4,4,4,7,7,7,7,7],
      [7,7,7,7,7,7,7,7,7,7,7,7,7,7,7,7,7,7,7,7,7,4,4,4,4,7,7,7,7,7],
      [7,7,7,7,7,7,7,7,7,7,7,7,7,7,7,7,7,7,7,7,7,4,4,4,4,7,7,7,7,7],
      [7,7,7,7,7,7,7,7,7,7,7,7,7,7,7,7,7,7,7,7,7,4,5,5,4,7,7,7,7,7],
      [7,7,7,7,7,7,7,7,7,7,7,7,7,7,7,7,7,7,7,7,7,4,3,3,4,7,7,7,7,7],
      [1,1,1,1,1,1,1,1,1,1,1,1,1,1,1,1,1,1,1,1,1,1,1,1,1,1,1,1,1,1],
      [6,6,6,6,6,6,6,6,6,6,6,6,6,6,6,6,6,6,6,6,6,6,6,6,6,6,6,6,6,6]
    ],
    "width": 960,
    "height": 544,
    "buildings": [
      {
        "edge": 672,
        "bounds": { "x": 672, "y": 256, "width": 128 }

      }
    ],
    "groundPosX": 480,
    "spriteSheet": "assets/building_32x32.png",
    "player": {
        "spriteSheet": "assets/tank_sheet_sm.png",
        "posX": 0,
        "posY": 0
    },
    "ufos": [
        {
            "spriteSheet": "assets/ufo_sheet.png",
            "posX": -50,
            "posY": 55,
            "dx": 5,
            "dy": 1,
            "laserFrequency": 90,
            "laserSpeed": 6,
            "yBoundary": 200
        }
    ],
    "aliens": [
      {
        "spriteSheet": "assets/alien_sheet.png",
        "strength": 1,
        "toxicity": 1,
        "offensiveness": 0
      }
    ],
    "explosions": [
      {
        "spriteSheet": "assets/explosion.png",
        "width": 130,
        "height": 130,
        "frames": 42,
        "columns": 6,
        "rows": 7
      }
    ]
  }
}
